########
#000000#
#002200#
#002200#
#000000#
#002200#
#002200#
#000000#
#002200#
#002200#
#000000#
#002200#
#002200#
#000000#
#002200#
#002200#
#000000#
#002200#
#002200#
#000000#
#002200#
#002200#
#000000#
########
