####################################################
#                                                  #
#  22  1111111111 1111111111 1111111111 1111111111 #
#  22  1111111111 1111111111 1111111111 1111111111 #
#                                                  #
#  22  1111111111 1111111111 1111111111 1111111111 #
#  22  1111111111 1111111111 1111111111 1111111111 #
#                                                  #
#  22  1111111111 1111111111 1111111111 1111111111 #
#  22  1111111111 1111111111 1111111111 1111111111 #
#                                                  #
#  22  1111111111 1111111111 1111111111 1111111111 #
#  22  1111111111 1111111111 1111111111 1111111111 #
#                                                  #
#  22  1111111111 1111111111 1111111111 1111111111 #
#  22  1111111111 1111111111 1111111111 1111111111 #
#                                                  #
#  22  1111111111 1111111111 1111111111 1111111111 #
#  22  1111111111 1111111111 1111111111 1111111111 #
#                                                  #
#  22  1111111111 1111111111 1111111111 1111111111 #
#  22  1111111111 1111111111 1111111111 1111111111 #
#                                                  #
####################################################